deras	APPGE
hir	APPGE
hys	APPGE
mah	APPGE
myn	APPGE
myne	APPGE
ther	APPGE
y'r	APPGE
ever'	AT
th'	AT
'n'	CC
aber	CC
an'	CC
nec	CC
'fore	CS
aftuh	CS
altho	CS
befoh	CS
bevor	CS
s'posin'	CS
so's	CS
synce	CS
thatt	CS
thet	CS
tho'	CS
yff	CS
'nough	DA
manye	DA
mor	DA
nuf	DA
ani	DD
anye	DD
enny	DD
'nother	DD1
thet	DD1
thease	DD2
thees	DD2
whichever-the-hell	DDQ
whosever	DDQGE
theare	EX
ther	EX
'bout	II
'cept	II
'ceptin'	II
'round	II
'till	II
att	II
beefore	II
behahn	II
behynde	II
considerin'	II
durin'	II
f'r	II
fer	II
foh	II
lahk	II
lak	II
towardes	II
uppon	II
vs.	II
with-but-after	II
anythin	PN1
ever'body	PN1
no-one	PN1
nothin	PN1
nothin'	PN1
somethin'	PN1
sompin	PN1
whoe	PNQS
whosoever	PNQS
their's	PPGE
'em	PPHO1
'im	PPHO1
hym	PPHO1
mee	PPHO1
thum	PPHO1
we'uns	PPHO1
hytt	PPHS1
dey	PPHS2
h'all	PPHS2
thay	PPHS2
thei	PPHS2
you'uns	PPHS2
yow	PPHS2
yuh	PPHS2
himselfe	PPX1
hymselfe	PPX1
ownself	PPX1
'emselves	PPX2
'?'	QEQ
exasperatingly	RG
insuperably	RG
mountainously	RG
severly	RG
shatteringly	RG
steamily	RG
unappeasably	RG
unimpeachably	RG
unmanageably	RG
unqualifiedly	RG
up-pp	RP
howe	RRQ
howsabout	RRQ
whah	RRQ
wheare	RRQ
wher	RRQ
whereever	RRQ
wuh	VBDR
bein	VBG
bein'	VBG
beinge	VBG
doo	VD0
dost	VD0
hev	VH0
hevin	VHG
hadd	VHN
c'n	VM
colde	VM
maht	VM
maye	VM
mayst	VM
shuld	VM
shulde	VM
wil	VM
wod	VM
wold	VM
wolde	VM
nawt	XX
