aegean	JJ
afro-asian	JJ
all-negro	JJ
allegoric	JJ
allocable	JJ
analeptic	JJ
anionic	JJ
aniseikonic	JJ
ante-bellum	JJ
anti-a	JJ
anti-b	JJ
anti-infective	JJ
anti-monopoly	JJ
anti-organization	JJ
anti-party	JJ
anti-secrecy	JJ
antithyroid	JJ
arteriolar	JJ
artery-pulmonary	JJ
atlantic	JJ
autonomic-somatic	JJ
basophilic	JJ
bel	JJ
belge	JJ
brahmsian	JJ
browny-haired	JJ
cathodoluminescent	JJ
cell-free	JJ
cents-per-hour	JJ
channel-type	JJ
chemische	JJ
chromatographic	JJ
clear-channel	JJ
clinico-pathologic	JJ
concretistic	JJ
congregational-baptist	JJ
consonantal	JJ
cortico-fugal	JJ
cortico-hypothalamic	JJ
cost-raising	JJ
cross-licensing	JJ
day-after-day	JJ
democratic-endorsed	JJ
demoniac	JJ
diagonalizable	JJ
diaphragmic	JJ
double-valued	JJ
entry-limiting	JJ
epiphyseal-diaphyseal	JJ
export-import	JJ
extra-sensory	JJ
eye-undeceiving	JJ
fast-closing	JJ
fast-opening	JJ
festivus	JJ
fiber-coupled	JJ
field-flattening	JJ
finite-dimensional	JJ
foot-loose	JJ
four-element	JJ
francaise	JJ
frost-bitten	JJ
generale	JJ
gentile-jewish	JJ
gerundial	JJ
glottochronological	JJ
green-brown	JJ
gute	JJ
gyro-stabilized	JJ
hard-surface	JJ
hebephrenic	JJ
high-rep	JJ
high-set	JJ
hit-run	JJ
hopkinsian	JJ
hydroxyl-rich	JJ
hyperemic	JJ
hypothalamic-cortical	JJ
individual-contributor	JJ
interlayer	JJ
interlobular	JJ
interstage	JJ
involutorial	JJ
knee-type	JJ
kohnstamm-negative	JJ
kohnstamm-positive	JJ
lacey	JJ
last-named	JJ
macropathological	JJ
medico-military	JJ
mediumistic	JJ
micrometeoritic	JJ
middle-	JJ
middle-south	JJ
molal	JJ
monic	JJ
mono-	JJ
mono-unsaturated	JJ
morphophonemic	JJ
multi-valued	JJ
music-loving	JJ
negro-appeal	JJ
neocortical-hypothalamic	JJ
nerve-shattering	JJ
neutralist	JJ
nilpotent	JJ
non-contributory	JJ
non-service-connected	JJ
non-supervisory	JJ
non-taxable	JJ
non-thermal	JJ
nondrying	JJ
nonsingular	JJ
north-south	JJ
oil-bearing	JJ
ole	JJ
oleophilic	JJ
one-gee	JJ
orney	JJ
over/under	JJ
oversoft	JJ
pacific	JJ
paraxial	JJ
patent-sharing	JJ
perennian	JJ
personally-owned	JJ
petits	JJ
phonologic	JJ
photoelectronic	JJ
pig-drunk	JJ
pincian	JJ
pit-run	JJ
plus-one	JJ
poly-unsaturated	JJ
post-attack	JJ
post-bellum	JJ
pre-legislative	JJ
pre-shaped	JJ
preparative	JJ
present-time	JJ
prima-facie	JJ
protogeometric	JJ
pseudo-anthropological	JJ
pseudo-glamorous	JJ
publick	JJ
publique	JJ
pyknotic	JJ
quadric	JJ
radar-controlled	JJ
reimburseable	JJ
repayable	JJ
resin-saturated	JJ
reticulate	JJ
self-unloading	JJ
semi-major	JJ
short-of-war	JJ
single-valued	JJ
soviet-chinese	JJ
spanish-american	JJ
stadtisches	JJ
staminate	JJ
state-local	JJ
sterling	JJ
straight-haired	JJ
subgross	JJ
surface-active	JJ
survey-type	JJ
textile-producing	JJ
third-dimensional	JJ
three-inch-wide	JJ
thrust-to-weight	JJ
tintable	JJ
titanic	JJ
trans-illuminated	JJ
trigonal	JJ
two-season	JJ
two-system	JJ
un-english	JJ
unallocable	JJ
undepicted	JJ
under-developed	JJ
unuttered	JJ
unwarrantable	JJ
upper-	JJ
upper-middle-	JJ
upward-mobile	JJ
vacuum-formed	JJ
varian	JJ
viewless	JJ
war-ridden	JJ
wont	JJ
wraith-like	JJ
yankee	JJ
abler	JJR
furiouser	JJR
safer	JJR
octillion	MC
one-	MC
eighty-fifth	MD
eighty-seventh	MD
eighty-sixth	MD
quintus	MD
second-	MD
olds	N
**ya	NN1
**yb	NN1
**yc	NN1
**ye	NN1
**yf	NN1
**yl	NN1
**yp	NN1
**yt	NN1
**zg	NN1
**zq	NN1
-ism	NN1
/l/	NN1
aab/	NN1
abo	NN1
abreaction	NN1
acetonemia	NN1
adc	NN1
aec	NN1
af-fold	NN1
af-stage	NN1
afl-cio	NN1
age-and-sex	NN1
agglutinin	NN1
aia	NN1
aimo	NN1
aleck	NN1
alfresco	NN1
alto	NN1
amethystine	NN1
ante	NN1
appestat	NN1
arm-elevation	NN1
arm-levitation	NN1
armhole	NN1
arroyo	NN1
arte	NN1
arteriolosclerosis	NN1
arylesterase	NN1
assignee	NN1
asw	NN1
autocollimator	NN1
autofluorescence	NN1
awoc	NN1
backstitch	NN1
baileefe	NN1
bawh	NN1
bbb	NN1
beebread	NN1
bin	NN1
bio-assay	NN1
bio-medicine	NN1
birth-prevention	NN1
biwa	NN1
black-body	NN1
bogy	NN1
bombus	NN1
brazil	NN1
bronc	NN1
bronchiole	NN1
bronchus	NN1
btu	NN1
burl	NN1
butyrate	NN1
b{t}	NN1
c-plane	NN1
calinda	NN1
calorimeter	NN1
carbonyl	NN1
carne	NN1
case-history	NN1
castor	NN1
catkin	NN1
cavalry	NN1
cdc	NN1
cen-tennial	NN1
centum	NN1
certiorari	NN1
change-over	NN1
chantey	NN1
charge-excess	NN1
chartist	NN1
chartroom	NN1
chlorothiazide	NN1
coahr	NN1
cochannel	NN1
cod	NN1
coffee-house	NN1
color-tv	NN1
comedie	NN1
committeewoman	NN1
conceptuality	NN1
cone-sphere	NN1
conelrad	NN1
conquete	NN1
conseil	NN1
contingent-fee	NN1
corne	NN1
cost-data	NN1
cps	NN1
crewel	NN1
crupper	NN1
cta	NN1
ctca	NN1
davenport	NN1
day-watch	NN1
deae-cellulose	NN1
deferent	NN1
definition-specialization	NN1
dell	NN1
demurrer	NN1
demythologization	NN1
detergency	NN1
di-iodotyrosine	NN1
diam	NN1
diethylaminoethyl	NN1
diety	NN1
differentiability	NN1
dimethylglyoxime	NN1
diocs	NN1
direct-sum	NN1
divertimento	NN1
dline	NN1
double-stage	NN1
double-step	NN1
drdw	NN1
dsw	NN1
dtf	NN1
duf	NN1
eeg	NN1
elution	NN1
enemy-jew	NN1
engineering-management	NN1
enthalpy	NN1
equ	NN1
escheat	NN1
esp	NN1
ethics	NN1
etv	NN1
excelsior	NN1
f-plane	NN1
fbi	NN1
fdr	NN1
feed-lot	NN1
feeding-pain	NN1
fela	NN1
felicity	NN1
fence-line	NN1
fha	NN1
fiberglas	NN1
fille	NN1
fin	NN1
finger-post	NN1
fitc	NN1
floc	NN1
folk-lore	NN1
food-preservation	NN1
forma	NN1
four-wood	NN1
fps	NN1
frankfurter	NN1
fueloil	NN1
fumed-oak	NN1
f{t}	NN1
gage	NN1
gaming-card	NN1
gapt	NN1
ginmill	NN1
gladius	NN1
glass-fiber	NN1
gnp	NN1
goitre	NN1
goitrogen	NN1
gop	NN1
graham	NN1
grand-daughter	NN1
grant-in-aid	NN1
grape-arbor	NN1
grokking	NN1
groundwave	NN1
gully	NN1
gyrocompass	NN1
g{t}	NN1
half-intensity	NN1
hamlet	NN1
handclasp	NN1
hande	NN1
hard-liquor	NN1
head-tossing	NN1
hemosiderin	NN1
hesiometer	NN1
hexameter	NN1
highpoint	NN1
highroad	NN1
hilum	NN1
histochemistry	NN1
hon	NN1
horse-radish	NN1
hoss	NN1
hostler	NN1
howse	NN1
hunter-killer	NN1
i-e	NN1
i-th	NN1
ibm	NN1
icbm	NN1
incipiency	NN1
infantry	NN1
interlining	NN1
interne	NN1
intima	NN1
intonaco	NN1
introject	NN1
iocs	NN1
iocsixf	NN1
iocsixg	NN1
iodination	NN1
irreproducibility	NN1
irsac	NN1
isocyanate	NN1
it-wit	NN1
jejunum	NN1
jew-baiter	NN1
jewishness	NN1
john	NN1
jour	NN1
journalese	NN1
jure	NN1
kedgeree	NN1
keelson	NN1
ken	NN1
krystallographie	NN1
kwhr	NN1
lana	NN1
large-package	NN1
lazybones	NN1
levy	NN1
lexicostatistics	NN1
liberty-and-union	NN1
lieutenant-governor	NN1
lineback	NN1
litorigin	NN1
lob-scuse	NN1
loc	NN1
low-moisture	NN1
lso	NN1
lubra	NN1
lunation	NN1
maku	NN1
malocclusion	NN1
mano	NN1
manometer	NN1
mart	NN1
matt	NN1
mc/sec	NN1
mg/l	NN1
mg/l/hr	NN1
micelle	NN1
micrometeorite	NN1
midsummer	NN1
millidegree	NN1
min	NN1
monacle	NN1
monei	NN1
mono-iodotyrosine	NN1
morphophonemics	NN1
mough	NN1
mph	NN1
mrad	NN1
multipactor	NN1
naebm	NN1
nato	NN1
nbc	NN1
nbs	NN1
ncta	NN1
negociant	NN1
neo-classicism	NN1
neutralism	NN1
neutralist	NN1
newt	NN1
nlrda	NN1
nocturne	NN1
nonreactivity	NN1
not-ace	NN1
nuclide	NN1
nyu	NN1
oas	NN1
odd-lot	NN1
oilheating	NN1
one-digit	NN1
organification	NN1
orthicon	NN1
overfall	NN1
oxytetracycline	NN1
oyabun	NN1
paot	NN1
paralanguage	NN1
paredon	NN1
parson	NN1
pater	NN1
patronne	NN1
pbs	NN1
peltry	NN1
phenothiazine	NN1
phonemics	NN1
photocathode	NN1
phs	NN1
pike	NN1
place-kicking	NN1
plugugly	NN1
poetry-and-jazz	NN1
polyether	NN1
pool-side	NN1
porter	NN1
portfolio-maker	NN1
possum-hunting	NN1
pre-primary	NN1
predicator	NN1
prepolymer	NN1
president-elect	NN1
prevision	NN1
price-consciousness	NN1
princesse	NN1
prix	NN1
proctor	NN1
prolixity	NN1
prolusion	NN1
proprieter	NN1
proteolysis	NN1
pseudo-capitalism	NN1
pseudo-thinking	NN1
pseudophloem	NN1
psi	NN1
ptc	NN1
public-limit	NN1
pyrometer	NN1
quetzal	NN1
quince	NN1
r-stage	NN1
race-driver	NN1
radiochlorine	NN1
radiopasteurization	NN1
radiosterilization	NN1
rca	NN1
rdw	NN1
rdws	NN1
re-birth	NN1
re-sharpening	NN1
redactor	NN1
redeposition	NN1
redoute	NN1
regulus	NN1
research-staff	NN1
resorcinol	NN1
restorability	NN1
rhinotracheitis	NN1
right-of-entry	NN1
rim-fire	NN1
rodder	NN1
romanza	NN1
roughcast	NN1
roundhead	NN1
rpm	NN1
ruh	NN1
rumdum	NN1
sacrificium	NN1
sanipractor	NN1
sawtimber	NN1
sba	NN1
scattergun	NN1
scr	NN1
scrutin	NN1
seato	NN1
secant	NN1
secco	NN1
self-certainty	NN1
self-will	NN1
serratus	NN1
short-contact	NN1
single-step	NN1
situs	NN1
skywave	NN1
slanderer	NN1
smu	NN1
snorkle	NN1
sowbelly	NN1
specter	NN1
sputnik	NN1
srelease	NN1
stake-out	NN1
stein	NN1
stephanotis	NN1
sub-interval	NN1
submucosa	NN1
subordinator	NN1
super-condamine	NN1
suspensor	NN1
switchgear	NN1
syllabicity	NN1
tablespoonful	NN1
tallyho	NN1
tangency	NN1
tappet	NN1
tass	NN1
tax-exemption	NN1
teacart	NN1
teddy	NN1
text-form	NN1
thermometry	NN1
thiouracil	NN1
thyroglobulin	NN1
time-&-motion	NN1
time-span	NN1
time-temperature	NN1
tnt	NN1
toll-road	NN1
top-tang	NN1
topgallant	NN1
torquer	NN1
total-cost	NN1
towne	NN1
transferor	NN1
transversus	NN1
tri-iodothyronine	NN1
triamcinolone	NN1
tripolyphosphate	NN1
triservice	NN1
tsh	NN1
tultul	NN1
tung	NN1
tyme	NN1
ultracentrifugation	NN1
ultracentrifuge	NN1
uranyl	NN1
usp	NN1
ussr	NN1
vacuolization	NN1
vapor-pressure	NN1
vasorum	NN1
vernier	NN1
vocational-advancement	NN1
volley-ball	NN1
w-region	NN1
wage-price	NN1
wave-length	NN1
wheat-germ	NN1
whiteface	NN1
wigmaker	NN1
wohaw	NN1
wtv	NN1
x-gyro	NN1
x-region	NN1
xrelease	NN1
y-cell	NN1
y-region	NN1
yachtel	NN1
yellow-dwarf	NN1
zero-magnitude	NN1
absorptions	NN2
agglutinins	NN2
alkalis	NN2
anastomoses	NN2
andrenas	NN2
antisera	NN2
apportionments	NN2
backbends	NN2
bonzes	NN2
broadcastings	NN2
bronchi	NN2
bull-sessions	NN2
cetera	NN2
chorines	NN2
committeemen	NN2
compulsives	NN2
conjugates	NN2
contadini	NN2
corroborees	NN2
cross-striations	NN2
crystallites	NN2
dactyls	NN2
debs	NN2
drapers	NN2
dromozoa	NN2
dynasts	NN2
dystopias	NN2
ellipsoids	NN2
epicycles	NN2
esterases	NN2
ethics	NN2
ex-liberals	NN2
facet-planes	NN2
fill-ins	NN2
five-elements	NN2
fords	NN2
francs	NN2
franks	NN2
gaieties	NN2
goitrogens	NN2
grants-in-aid	NN2
habitants	NN2
handspikes	NN2
hartes	NN2
hay-shakers	NN2
headwalls	NN2
heavers	NN2
heavy-electrical-goods	NN2
hopples	NN2
hosses	NN2
hydrides	NN2
hydrogens	NN2
inholdings	NN2
intensifiers	NN2
involutions	NN2
isopleths	NN2
kennings	NN2
kolkhozes	NN2
lay-sisters	NN2
levis	NN2
lieder	NN2
longhorns	NN2
macro-instructions	NN2
maladjustments	NN2
manhours	NN2
marketings	NN2
meanes	NN2
memory-images	NN2
micelles	NN2
millidegrees	NN2
myofibrillae	NN2
neutralists	NN2
nomias	NN2
nonreactors	NN2
nucleoli	NN2
nymphomaniacs	NN2
ones	NN2
orthographies	NN2
out-migrants	NN2
over-achievers	NN2
overnighters	NN2
oxygens	NN2
palisades	NN2
pegboards	NN2
peptidases	NN2
photocathodes	NN2
piers	NN2
plain-clothesmen	NN2
poises	NN2
polyesters	NN2
polyphosphates	NN2
portwatchers	NN2
preambles	NN2
previsions	NN2
prolusions	NN2
race-drivers	NN2
rata	NN2
repulsions	NN2
resultants	NN2
revolutionibus	NN2
rim-fires	NN2
secants	NN2
sensitives	NN2
sera	NN2
shoals	NN2
skiis	NN2
statistics	NN2
status-roles	NN2
sub-tests	NN2
suds	NN2
synchronizers	NN2
tappets	NN2
tektites	NN2
telegraphers	NN2
time-servers	NN2
torquers	NN2
tree-clumps	NN2
unoriginals	NN2
urethanes	NN2
verbenas	NN2
wales	NN2
wander-years	NN2
week-ends	NN2
wiles	NN2
agin	RR
algebraically	RR
discordantly	RR
efficaciously	RR
hereunto	RR
jist	RR
nonspecifically	RR
onleh	RR
professedly	RR
reflexly	RR
supra	RR
thar	RR
ther	RR
thereupon	RR
versa	RR
yehhh	RR
atta	UH
christ	UH
hubba	UH
jesus	UH
pip	UH
pugh	UH
sure-sure	UH
uhhu	UH
zounds	UH
agglomerate	VV0
backstitch	VV0
center-punch	VV0
dishearten	VV0
draw-file	VV0
esse	VV0
figger	VV0
forgit	VV0
grok	VV0
heare	VV0
inure	VV0
levy	VV0
outface	VV0
paie	VV0
summate	VV0
tack-solder	VV0
thinke	VV0
vade	VV0
about-faced	VVD
grokked	VVD
tooke	VVD
wisecracked	VVD
a-coming	VVG
chinning	VVG
coning	VVG
de-iodinating	VVG
defocusing	VVG
dimensioning	VVG
incepting	VVG
iodinating	VVG
leavin	VVG
lyking	VVG
poetizing	VVG
rodding	VVG
tensioning	VVG
thermoforming	VVG
thinkin	VVG
blest	VVN
damed	VVN
datelined	VVN
demythologized	VVN
dialyzed	VVN
equilibrated	VVN
iodinated	VVN
kidnaped	VVN
over-emphasized	VVN
oxidised	VVN
preconditioned	VVN
prejudged	VVN
preprepared	VVN
programed	VVN
resuspended	VVN
rough-sanded	VVN
slaked	VVN
sorbed	VVN
vue	VVN
believeth	VVZ
interpenetrates	VVZ
lets	VVZ
mars	VVZ
obtrudes	VVZ
saith	VVZ
trusteth	VVZ
